28 21

0 0 0 0 0 0 0 0 0 0 0 0 0 0 0 0 0 0 0 0 0
0 0 0 0 0 0 0 0 0 0 0 0 0 0 0 0 0 0 0 0 0
0 0 0 0 0 0 0 0 0 0 0 0 0 0 0 0 0 0 0 0 0
0 0 0 0 0 0 0 0 0 0 0 0 0 0 0 0 0 0 0 0 0
0 0 0 0 0 0 0 0 0 0 0 0 0 0 0 0 0 0 0 0 0
0 0 0 0 0 0 0 0 0 0 0 0 0 0 0 0 0 0 0 0 0
8 0 0 0 0 0 0 0 0 0 0 0 0 0 0 0 0 0 0 0 8
0 3 0 3 0 3 0 3 0 3 0 3 0 3 0 3 0 3 0 3 0
8 0 0 0 0 0 0 0 0 0 0 0 0 0 0 0 0 0 0 0 8
0 1 0 1 0 1 0 1 0 1 0 1 0 6 0 1 0 1 0 1 0
8 0 0 0 0 0 0 0 0 0 0 0 0 0 0 0 0 0 0 0 8
0 2 0 5 0 2 0 7 0 2 0 2 0 2 0 2 0 9 0 2 0
8 0 0 0 0 0 0 0 0 0 0 0 0 0 0 0 0 0 0 0 8
0 1 0 1 0 1 0 1 0 9 0 1 0 1 0 1 0 1 0 1 0
8 0 0 0 0 0 0 0 0 0 0 0 0 0 0 0 0 0 0 0 8
0 2 0 7 0 2 0 2 0 2 0 2 0 2 0 2 0 7 0 2 0
8 0 0 0 0 0 0 0 0 0 0 0 0 0 0 0 0 0 0 0 8
0 5 0 1 0 1 0 6 0 1 0 7 0 1 0 1 0 1 0 1 0
8 0 0 0 0 0 0 0 0 0 0 0 0 0 0 0 0 0 0 0 8
0 3 0 3 0 3 0 3 0 3 0 3 0 3 0 3 0 3 0 3 0
8 0 0 0 0 0 0 0 0 0 0 0 0 0 0 0 0 0 0 0 8
0 0 0 0 0 0 0 0 0 0 0 0 0 0 0 0 0 0 0 0 0
0 0 0 0 0 0 0 0 0 0 0 0 0 0 0 0 0 0 0 0 0
0 0 0 0 0 0 0 0 0 0 0 0 0 0 0 0 0 0 0 0 0
0 0 0 0 0 0 0 0 0 0 0 0 0 0 0 0 0 0 0 0 0
0 0 0 0 0 0 0 0 0 0 0 0 0 0 0 0 0 0 0 0 0
0 0 0 0 0 0 0 0 0 0 0 0 0 0 0 0 0 0 0 0 0
0 0 0 0 0 0 0 0 0 0 0 0 0 0 0 0 0 0 0 0 0