28 21

0 0 0 0 0 0 0 0 0 0 0 0 0 0 0 0 0 0 0 0 0
0 0 0 0 0 0 0 0 0 0 0 0 0 0 0 0 0 0 0 0 0
0 0 0 0 0 0 0 0 0 0 0 0 0 0 0 0 0 0 0 0 0
0 0 0 0 0 0 0 0 0 0 0 0 0 0 0 0 0 0 0 0 0
0 0 0 0 0 0 0 0 0 0 0 0 0 0 0 0 0 0 0 0 0 
0 0 0 0 0 0 0 0 0 0 0 0 0 0 0 0 0 0 0 0 0
0 0 0 0 0 0 0 0 0 0 0 0 0 0 0 0 0 0 0 0 0 
0 0 0 0 3 2 3 2 3 2 3 2 3 2 3 0 0 0 0 0 0
0 0 0 0 2 1 1 1 1 1 1 1 1 1 1 2 0 0 0 0 0
0 0 0 0 0 3 1 7 1 1 0 1 1 7 1 1 0 0 0 0 0 
0 0 0 0 0 0 1 1 6 0 0 0 6 1 1 2 0 0 0 0 0
0 0 0 0 0 0 2 1 1 0 0 0 1 1 1 1 0 0 0 0 0
0 0 0 0 0 0 1 5 1 0 0 0 1 7 1 2 0 0 0 0 0
0 0 0 0 0 0 2 1 1 0 0 0 1 1 1 9 0 0 0 0 0
0 0 0 0 0 0 9 1 1 0 0 0 1 1 1 2 0 0 0 0 0
0 0 0 0 0 0 2 7 1 0 0 0 1 5 1 1 0 0 0 0 0
0 0 0 0 0 0 1 1 1 0 0 0 1 1 1 2 0 0 0 0 0
0 0 0 0 0 0 2 1 6 0 0 0 6 1 1 1 0 0 0 0 0 
0 0 0 0 0 3 1 7 1 1 0 1 1 7 1 2 0 0 0 0 0
0 0 0 0 2 1 1 1 1 1 1 1 1 1 1 1 0 0 0 0 0
0 0 0 0 3 2 3 2 3 2 3 2 3 2 3 0 0 0 0 0 0
0 0 0 0 0 0 0 0 0 0 0 0 0 0 0 0 0 0 0 0 0
0 0 0 0 0 0 0 0 0 0 0 0 0 0 0 0 0 0 0 0 0
0 0 0 0 0 0 0 0 0 0 0 0 0 0 0 0 0 0 0 0 0
0 0 0 0 0 0 0 0 0 0 0 0 0 0 0 0 0 0 0 0 0
0 0 0 0 0 0 0 0 0 0 0 0 0 0 0 0 0 0 0 0 0 
0 0 0 0 0 0 0 0 0 0 0 0 0 0 0 0 0 0 0 0 0
0 0 0 0 0 0 0 0 0 0 0 0 0 0 0 0 0 0 0 0 0